Cathedrale 21 23
x x x x x x x x 0 0 0 0 0 x x x x x x x x
x x x x 1 1 1 1 2 x g x 3 1 1 1 1 x x x x
x x x x 2 x x x x x x x x x x x 3 x x x x
1 1 1 1 2 x x x x x x x x x x x 3 1 1 1 1
2 x x x 4 x x x x x x x x x x x 4 x x x 3
2 x x x 4 x x x 3 1 1 1 2 x x x 4 x x x 3
2 x x x x x x x 5 x x x 6 x x x x x x x 3
2 g x x x x x x x x f x x x x x x x x g 3
2 x x x x x x x x p x p x x x x x x x x 3
2 x x x 4 x x x x x x x x x x x 4 x x x 3
2 x x x 4 x x x x x x x x x x x 4 x x x 3
3 1 1 1 2 x x x x x x x x x x x 3 1 1 1 2
x x 2 x x x x x x x x x x x x x x x 3 x x
x x 2 x x x x x x x x x x x x x x x 3 x x
x x 2 x x x x 3 2 x x x 3 2 x x x x 3 x x
x x 2 x x x x 3 2 x x x 3 2 x x x x 3 x x
x x 2 x x x x x x x x x x x x x x x 3 x x
x x 2 x x x x x x x x x x x x x x x 3 x x
x x 2 x x x x 3 2 x x x 3 2 x x x x 3 x x
x x 2 x x x x 3 2 x x x 3 2 x x x x 3 x x
x x 2 x x x x x x x x x x x x x x x 3 x x
x x 2 x x g x x x x g x x x x g x x 3 x x
x x 0 0 0 0 0 0 0 0 0 0 0 0 0 0 0 0 0 x x