Foret 25 22
0 0 0 0 0 0 0 0 0 0 0 0 0 0 0 0 0 0 0 0 0 0 0 0 0
0 x x x x x x x x g x x x g x x x x x x x x x x 0
0 x x x x x x x x x x x x x x x x x x x x x x x 0
0 x x x x x 7 x x x x x x x x x x x x x x x x x 0
0 x x x x x x x x x x x x x x x x x x 9 x x x x 0
0 x x x x x x x x x x x x x 8 x x x x x x x x x 0
0 x x x x x x 9 4 x x x x x x x 4 x x x x x x x 0
0 x x x x x x 3 1 2 5 x x x 6 3 1 2 x x x x x x 0
0 x 8 x x x x x x x x x x x x x x x x x x x 8 x 0
0 9 x x 4 x x x x x x p x p x x x x x x 4 x x x 0
0 x x x 4 7 x x x x x x f x x x x x x x 4 x x x 0
0 x x x 4 x x x x x x x x x x x x x x 7 4 x x x 0
0 x x x 4 x x x x x x x x x x x x x x x 4 x x x 0
0 x x x x x x x x x x x x x x x x x x x x x x x 0
0 g x x x x x x x x 3 1 1 1 2 x x x x x x x x g 0
0 x x x x x x x x x x x 4 x x x x x x x x x x x 0
0 x x x x x x x x 8 x x x x x x x x x x x x x x 0
0 x x x x x x x x x x x x x x x 9 x x x x x x x 0
0 x x x x x x x x x x x 7 x x x x x x x x x x x 0
0 x x x x x x x x x x x x x x x x x x x x x x x 0
0 x x x x x x g x x x x x x x x x g x x x x x x 0
0 0 0 0 0 0 0 0 0 0 0 0 0 0 0 0 0 0 0 0 0 0 0 0 0